R 1920 1080



NO    textures/wall_4.xpm
SO textures/bluestone.xpm
WE textures/wall_1.xpm
EA textures/wall_3.xpm
S textures/sprite_1.xpm

C 255,0,0
F 255,0,0

1111111111111111111111111
1000000000000000000000001
1000002000000000021110011
10010000000S020001   1000111111111
110000020022002000111000000000001
100000000000000000000000000011111
11110111111111011100000010001
11101111011 11011101010010001
11000000110101011100000010001
10000000000000001100000010001
100000000000000011010100100011
1100000111010101111101111000111
1111011101110101 101111010001
111 111111111111 11111111111